PTS test results for A2DP

PTS version: 5.0
Tested: --not yet tested--

Results:
PASS	test passed
FAIL	test failed
INC	test is inconclusive
N/A	test is disabled due to PICS setup

		Source (SRC)
-------------------------------------------------------------------------------
Test Name		Result	Notes
-------------------------------------------------------------------------------
TC_SRC_CC_BV_09_I	INC
TC_SRC_CC_BV_10_I	N/A
TC_SRC_REL_BV_01_I	INC
TC_SRC_REL_BV_02_I	INC
TC_SRC_SET_BV_01_I	INC
TC_SRC_SET_BV_02_I	INC
TC_SRC_SET_BV_03_I	INC
TC_SRC_SET_BV_04_I	INC
TC_SRC_SET_BV_05_I	INC
TC_SRC_SET_BV_06_I	INC
TC_SRC_SUS_BV_01_I	INC
TC_SRC_SUS_BV_02_I	INC
TC_SRC_SDP_BV_01_I	INC
TC_SRC_AS_BV_01_I	INC
-------------------------------------------------------------------------------


		Sink (SNK)
-------------------------------------------------------------------------------
Test Name		Result	Notes
-------------------------------------------------------------------------------
TC_SNK_CC_BV_01_I	N/A
TC_SNK_CC_BV_02_I	N/A
TC_SNK_CC_BV_03_I	N/A
TC_SNK_CC_BV_04_I	N/A
TC_SNK_CC_BV_05_I	N/A
TC_SNK_CC_BV_06_I	N/A
TC_SNK_CC_BV_07_I	N/A
TC_SNK_CC_BV_08_I	N/A
TC_SNK_REL_BV_01_I	N/A
TC_SNK_REL_BV_02_I	N/A
TC_SNK_SET_BV_01_I	N/A
TC_SNK_SET_BV_02_I	N/A
TC_SNK_SET_BV_03_I	N/A
TC_SNK_SET_BV_04_I	N/A
TC_SNK_SET_BV_05_I	N/A
TC_SNK_SET_BV_06_I	N/A
TC_SNK_SUS_BV_01_I	N/A
TC_SNK_SUS_BV_02_I	N/A
TC_SNK_SDP_BV_02_I	N/A
TC_SNK_AS_BV_01_I	N/A
-------------------------------------------------------------------------------
